1111111111111111111111111111
1000000000000110000000000001
1011110111110110111110111101
1E11110111110110111110111101
101C11C111110110111110111101
1P0C0C0000000000000000000001
1111111111111111111111111111