11111
1E0P1
10PC1
1C001
11111
