111111111111111111111111111111
110000000P00000000000000000001
111111110111111111111111111111
10000000000E000CCC110000000001
111111111111111111111111111111