111111111111111111111111111111
1P0000000000000000000000000001
101111111111110000000011100001
100000000000000CCC110000000001
100000000000000000110000000001
100000000001000000000100000001
101111110001110110CCC1001C0001
100000000000000000000111110001
101111110000100000000100000001
1010000100001000000000000000C1
10100C0100001001111111100000C1
1010000100001000000000000000C1
1010000100001CC1111111100C0001
100000CC000010000C000000000001
1000001100001001100001100000C1
100000110000100000000000000001
1CC00000000C100E00000000000001
1111111111111111111111111110C1
111111111111111111111111111111