111111111111111111111111111111
1P0000000000000000000000000001
101111111111110000000011100001
100000000000000C0C110000000001
100000000C00000000110000000001
100000000001000000000100000001
101111110001110110CCC100100001
100000000000000000000111110001
100000110000100110000110000001
100000110000100000000000000001
100000000000100E00000000000001
111111111111111111111111111111
111111111111111111111111111111