1111111111111111111111111111
1000000000000110000000000001
1011110111110110111110111101
1E111101111101101111101111E1
1011110111110110111110111101
1000000000000000000000000001
1011110110111111110110111101
1011110110111111110110111101
1000000110000110000110000001
1111110111110110111110111111
1111110111110110111110111111
1111110100000000000010111111
1111110101111001111010111111
1000000001C00CC00C1000000001
1111110101111111111010111111
1111110100000000000010111111
1111110101111111111010111111
1000000000000110000000000001
1011110111110110111110111101
1011110111110110111110111101
1E001100000000000000001100E1
1110110110111111110110110111
1110110110111111110110110111
1000000110000110000110000001
1011111111110110111111111101
10000000000000P0000000000001
1111111111111111111111111111