11111
1P001
100C1
1C001
11111
