11111
1E001
100C1
1C001
11111
