1111111111111111111111111
1110000000000000000000111
10000000P0000010000000011
1000100000000000000010001
100000000000E000000000001
1100000001000000010000011
1110000000000000000000111
1111111111111111111111111
